WWWWWWWWWWWWWWWWWWWWWWWWWWWWWWWWWWWWWW
W   E WWW   W      W         W     E W
W WW  W     W WWW WWWW WWWWW W WWWW  W
W           W  W    W   W    W W  W  W
WWWWWWWWWW          W   WWWW W    W  W
W       E  W W  W             WWWWWW W
WWWWWW W WW  W  W  WWWW WWW          W
W   W     W  W  W  WWWW W W W W WWWW W
W   WWWW  W  W     W    W   W W    W W
W         W     W  WWWW W W WWW WWWW W
WWWWWWWWWWWWWWWWWWW    W W W   W   W W
W      E            WW             W W
W WWWWWWWWWWWWWWWWW    WWWWWWWWWWW W W
W W               WWWWWW         W W W
W W WWWWWWWWWWWWW W    W WWWWWWWWW W W
W W             W   WW             W W
W WWWWWWWWWWWWWWWWWWWWWWWWWWWWWWWWWW W
W                                    W
WWWWWWWWWWWWWWWWWWWWWWWWWWWWWWWWWWWWWW