WWWWWWWWWWWWW
W E   W E   W
WWWWWWW     W
W           W
W     W     W
W E   W E   W
WWWWWWWWWWWWWW